(supertux-level
  (version 3)
  (name (_ "Welcome To Snowy Land"))
  (author "Sophie Ball")
  (license "CC-BY-SA 4.0 International")
  (target-time 59)
  (allow-item-pocket "inherit")
  (icon "")
  (icon-locked "")
  (statistics
    (enable-coins #t)
    (enable-secrets #t)
  )
  (sector
    (name "main")
    (ambient-light
      (color 1 1 1)
    )
    (background
      (color 1 1 1)
      (speed 0.5)
      (image-top "/images/background/misc/transparent_up.png")
      (image "/images/background/antarctic/semi_arctic_middle.png")
      (image-bottom "/images/background/antarctic/semi_arctic_bottom.png")
    )
    (bonusblock
      (z-pos 51)
      (x 1536)
      (y 1344)
    )
    (bonusblock
      (z-pos 51)
      (x 1568)
      (y 1344)
    )
    (bonusblock
      (z-pos 51)
      (x 1600)
      (y 1344)
    )
    (bonusblock
      (z-pos 51)
      (x 2560)
      (y 1472)
    )
    (bonusblock
      (z-pos 51)
      (x 2592)
      (y 1472)
    )
    (bonusblock
      (z-pos 51)
      (contents "firegrow")
      (x 2400)
      (y 1472)
    )
    (bonusblock
      (z-pos 51)
      (x 2368)
      (y 1472)
    )
    (bonusblock
      (z-pos 51)
      (x 2208)
      (y 1472)
    )
    (bonusblock
      (z-pos 51)
      (x 2176)
      (y 1472)
    )
    (bonusblock
      (z-pos 51)
      (x 4960)
      (y 864)
    )
    (bonusblock
      (z-pos 51)
      (x 4928)
      (y 864)
    )
    (bonusblock
      (z-pos 51)
      (x 4992)
      (y 864)
    )
    (bonusblock
      (z-pos 51)
      (x 4896)
      (y 864)
    )
    (bonusblock
      (z-pos 51)
      (x 5024)
      (y 864)
    )
    (bonusblock
      (z-pos 51)
      (x 5952)
      (y 672)
    )
    (bonusblock
      (z-pos 51)
      (contents "firegrow")
      (x 5856)
      (y 672)
    )
    (bonusblock
      (z-pos 51)
      (x 5664)
      (y 672)
    )
    (bonusblock
      (z-pos 51)
      (x 5568)
      (y 672)
    )
    (bonusblock
      (z-pos 51)
      (x 5792)
      (y 544)
    )
    (bonusblock
      (z-pos 51)
      (x 5760)
      (y 544)
    )
    (bonusblock
      (z-pos 51)
      (x 5728)
      (y 544)
    )
    (bonusblock
      (z-pos 51)
      (x 5632)
      (y 544)
    )
    (bonusblock
      (z-pos 51)
      (x 5600)
      (y 544)
    )
    (bonusblock
      (z-pos 51)
      (x 5888)
      (y 544)
    )
    (bonusblock
      (z-pos 51)
      (x 5920)
      (y 544)
    )
    (bonusblock
      (z-pos 51)
      (x 5824)
      (y 416)
    )
    (bonusblock
      (z-pos 51)
      (x 5856)
      (y 416)
    )
    (bonusblock
      (z-pos 51)
      (x 5696)
      (y 416)
    )
    (bonusblock
      (z-pos 51)
      (x 5664)
      (y 416)
    )
    (bonusblock
      (z-pos 51)
      (x 5728)
      (y 288)
    )
    (bonusblock
      (z-pos 51)
      (x 5760)
      (y 288)
    )
    (bonusblock
      (z-pos 51)
      (x 5792)
      (y 288)
    )
    (bonusblock
      (z-pos 51)
      (contents "1up")
      (x 10240)
      (y 416)
    )
    (bonusblock
      (z-pos 51)
      (x 10848)
      (y 672)
    )
    (bonusblock
      (z-pos 51)
      (contents "firegrow")
      (x 10880)
      (y 672)
    )
    (bonusblock
      (z-pos 51)
      (x 10912)
      (y 672)
    )
    (bonusblock
      (z-pos 51)
      (x 10944)
      (y 672)
    )
    (bonusblock
      (z-pos 51)
      (x 10976)
      (y 672)
    )
    (bonusblock
      (z-pos 51)
      (contents "explode")
      (x 11008)
      (y 672)
    )
    (bonusblock
      (z-pos 51)
      (x 11040)
      (y 672)
    )
    (bonusblock
      (z-pos 51)
      (x 11072)
      (y 672)
    )
    (bonusblock
      (z-pos 51)
      (x 14016)
      (y 896)
    )
    (bonusblock
      (z-pos 51)
      (x 13984)
      (y 896)
    )
    (bonusblock
      (z-pos 51)
      (x 13824)
      (y 1696)
    )
    (bonusblock
      (z-pos 51)
      (x 13792)
      (y 1696)
    )
    (bonusblock
      (z-pos 51)
      (contents "1up")
      (x 13760)
      (y 1696)
    )
    (bonusblock
      (z-pos 51)
      (x 13728)
      (y 1696)
    )
    (bonusblock
      (z-pos 51)
      (x 13696)
      (y 1696)
    )
    (bouncingsnowball
      (z-pos 50)
      (x 9280)
      (y 992)
      (glinting #f)
    )
    (bouncingsnowball
      (z-pos 50)
      (x 15616)
      (y 1280)
      (glinting #f)
    )
    (brick
      (z-pos 51)
      (x 2144)
      (y 1472)
      (breakable #t)
    )
    (brick
      (z-pos 51)
      (x 2240)
      (y 1472)
      (breakable #t)
    )
    (brick
      (z-pos 51)
      (x 2336)
      (y 1472)
      (breakable #t)
    )
    (brick
      (z-pos 51)
      (x 2432)
      (y 1472)
      (breakable #t)
    )
    (brick
      (z-pos 51)
      (x 2528)
      (y 1472)
      (breakable #t)
    )
    (brick
      (z-pos 51)
      (x 2624)
      (y 1472)
      (breakable #t)
    )
    (brick
      (z-pos 51)
      (x 5536)
      (y 672)
      (breakable #t)
    )
    (brick
      (z-pos 51)
      (x 5600)
      (y 672)
      (breakable #t)
    )
    (brick
      (z-pos 51)
      (x 5632)
      (y 672)
      (breakable #f)
    )
    (brick
      (z-pos 51)
      (x 5696)
      (y 672)
      (breakable #t)
    )
    (brick
      (z-pos 51)
      (x 5984)
      (y 672)
      (breakable #t)
    )
    (brick
      (z-pos 51)
      (x 5920)
      (y 672)
      (breakable #t)
    )
    (brick
      (z-pos 51)
      (x 5888)
      (y 672)
      (breakable #t)
    )
    (brick
      (z-pos 51)
      (x 5824)
      (y 672)
      (breakable #t)
    )
    (brick
      (z-pos 51)
      (x 13952)
      (y 896)
      (breakable #t)
    )
    (brick
      (z-pos 51)
      (x 14048)
      (y 896)
      (breakable #t)
    )
    (bumper
      (z-pos 50)
      (x 10432)
      (y 1216)
    )
    (bumper
      (z-pos 50)
      (x 13184)
      (y 928)
    )
    (camera
      (name "Camera")
      (mode "normal")
    )
    (coin
      (z-pos 49)
      (x 416)
      (y 1344)
    )
    (coin
      (z-pos 49)
      (x 448)
      (y 1312)
    )
    (coin
      (z-pos 49)
      (x 480)
      (y 1344)
    )
    (coin
      (z-pos 49)
      (x 512)
      (y 1312)
    )
    (coin
      (z-pos 49)
      (x 544)
      (y 1344)
    )
    (coin
      (z-pos 49)
      (x 576)
      (y 1312)
    )
    (coin
      (z-pos 49)
      (x 608)
      (y 1344)
    )
    (coin
      (z-pos 49)
      (x 640)
      (y 1312)
    )
    (coin
      (z-pos 49)
      (x 1504)
      (y 1440)
    )
    (coin
      (z-pos 49)
      (x 1536)
      (y 1440)
    )
    (coin
      (z-pos 49)
      (x 1568)
      (y 1440)
    )
    (coin
      (z-pos 49)
      (x 1600)
      (y 1440)
    )
    (coin
      (z-pos 49)
      (x 1632)
      (y 1440)
    )
    (coin
      (z-pos 49)
      (x 2816)
      (y 1408)
    )
    (coin
      (z-pos 49)
      (x 2848)
      (y 1376)
    )
    (coin
      (z-pos 49)
      (x 2880)
      (y 1344)
    )
    (coin
      (z-pos 49)
      (x 2912)
      (y 1312)
    )
    (coin
      (z-pos 49)
      (x 2944)
      (y 1344)
    )
    (coin
      (z-pos 49)
      (x 3744)
      (y 1088)
    )
    (coin
      (z-pos 49)
      (x 3744)
      (y 1056)
    )
    (coin
      (z-pos 49)
      (x 3744)
      (y 1024)
    )
    (coin
      (z-pos 49)
      (x 3744)
      (y 992)
    )
    (coin
      (z-pos 49)
      (x 3744)
      (y 960)
    )
    (coin
      (z-pos 49)
      (x 3744)
      (y 928)
    )
    (coin
      (z-pos 49)
      (x 3744)
      (y 896)
    )
    (coin
      (z-pos 49)
      (x 4864)
      (y 960)
    )
    (coin
      (z-pos 49)
      (x 4928)
      (y 960)
    )
    (coin
      (z-pos 49)
      (x 4992)
      (y 960)
    )
    (coin
      (z-pos 49)
      (x 5056)
      (y 960)
    )
    (coin
      (z-pos 49)
      (x 5568)
      (y 896)
    )
    (coin
      (z-pos 49)
      (x 5696)
      (y 896)
    )
    (coin
      (z-pos 49)
      (x 5952)
      (y 896)
    )
    (coin
      (z-pos 49)
      (x 5824)
      (y 896)
    )
    (coin
      (z-pos 49)
      (x 5760)
      (y 896)
    )
    (coin
      (z-pos 49)
      (x 7360)
      (y 512)
    )
    (coin
      (z-pos 49)
      (x 7520)
      (y 512)
    )
    (coin
      (z-pos 49)
      (x 7456)
      (y 512)
    )
    (coin
      (z-pos 49)
      (x 7424)
      (y 512)
    )
    (coin
      (z-pos 49)
      (x 8000)
      (y 544)
    )
    (coin
      (z-pos 49)
      (x 8032)
      (y 512)
    )
    (coin
      (z-pos 49)
      (x 8064)
      (y 512)
    )
    (coin
      (z-pos 49)
      (x 8096)
      (y 544)
    )
    (coin
      (z-pos 49)
      (x 8352)
      (y 544)
    )
    (coin
      (z-pos 49)
      (x 8320)
      (y 512)
    )
    (coin
      (z-pos 49)
      (x 8288)
      (y 512)
    )
    (coin
      (z-pos 49)
      (x 8256)
      (y 544)
    )
    (coin
      (z-pos 49)
      (x 8864)
      (y 896)
    )
    (coin
      (z-pos 49)
      (x 8896)
      (y 864)
    )
    (coin
      (z-pos 49)
      (x 8928)
      (y 864)
    )
    (coin
      (z-pos 49)
      (x 8960)
      (y 896)
    )
    (coin
      (z-pos 49)
      (x 9248)
      (y 896)
    )
    (coin
      (z-pos 49)
      (x 9216)
      (y 864)
    )
    (coin
      (z-pos 49)
      (x 9184)
      (y 864)
    )
    (coin
      (z-pos 49)
      (x 9152)
      (y 896)
    )
    (coin
      (z-pos 49)
      (x 9344)
      (y 1184)
    )
    (coin
      (z-pos 49)
      (x 9344)
      (y 1216)
    )
    (coin
      (z-pos 49)
      (x 9376)
      (y 1248)
    )
    (coin
      (z-pos 49)
      (x 9376)
      (y 1216)
    )
    (coin
      (z-pos 49)
      (x 9408)
      (y 1248)
    )
    (coin
      (z-pos 49)
      (x 9344)
      (y 1248)
    )
    (coin
      (z-pos 49)
      (x 9664)
      (y 1472)
    )
    (coin
      (z-pos 49)
      (x 9664)
      (y 1504)
    )
    (coin
      (z-pos 49)
      (x 9696)
      (y 1504)
    )
    (coin
      (z-pos 49)
      (x 13920)
      (y 992)
    )
    (coin
      (z-pos 49)
      (x 14080)
      (y 992)
    )
    (coin
      (z-pos 49)
      (x 13984)
      (y 992)
    )
    (coin
      (z-pos 49)
      (x 14016)
      (y 992)
    )
    (coin
      (z-pos 49)
      (x 14976)
      (y 1280)
    )
    (coin
      (z-pos 49)
      (x 15232)
      (y 1280)
    )
    (coin
      (z-pos 49)
      (x 15104)
      (y 1280)
    )
    (coin
      (z-pos 49)
      (x 15168)
      (y 1280)
    )
    (coin
      (z-pos 49)
      (x 15040)
      (y 1280)
    )
    (coin
      (z-pos 49)
      (x 15680)
      (y 1280)
    )
    (coin
      (z-pos 49)
      (x 15616)
      (y 1280)
    )
    (coin
      (z-pos 49)
      (x 15552)
      (y 1280)
    )
    (coin
      (z-pos 49)
      (x 15488)
      (y 1280)
    )
    (coin
      (z-pos 49)
      (x 15424)
      (y 1280)
    )
    (crusher
      (z-pos 50)
      (x 7520)
      (y 800)
    )
    (crusher
      (z-pos 50)
      (x 7200)
      (y 544)
    )
    (decal
      (z-pos 50)
      (sprite "/images/decal/misc/flag.sprite")
      (x 16000)
      (y 896)
    )
    (decal
      (z-pos -100)
      (sprite "/images/decal/snow/igloo_bg.png")
      (x 16384)
      (y 1024)
    )
    (decal
      (z-pos 100)
      (sprite "/images/decal/snow/igloo_fg.png")
      (x 16384)
      (y 1024)
    )
    (door
      (z-pos -99)
      (sector "main")
      (locked #f)
      (spawnpoint "two")
      (x 13504)
      (y 1728)
    )
    (firefly
      (z-pos 0)
      (x 5760)
      (y 736)
    )
    (flame
      (z-pos 150)
      (x 11616)
      (y 928)
    )
    (flame
      (z-pos 150)
      (x 12288)
      (y 1056)
    )
    (flame
      (z-pos 150)
      (x 12960)
      (y 928)
    )
    (gradient
      (top_color 0.5 0.7 1)
      (bottom_color 1 1 1)
      (z-pos -400)
    )
    (invisible_block
      (sprite "/images/objects/bonus_block/snowyland/hiddenbonus.sprite")
      (z-pos 51)
      (x 10304)
      (y 928)
    )
    (invisible_block
      (sprite "/images/objects/bonus_block/snowyland/hiddenbonus.sprite")
      (z-pos 51)
      (x 10304)
      (y 800)
    )
    (invisible_block
      (sprite "/images/objects/bonus_block/snowyland/hiddenbonus.sprite")
      (z-pos 51)
      (x 10304)
      (y 672)
    )
    (invisible_wall
      (width 64)
      (height 64)
      (x 16672)
      (y 1152)
    )
    (jumpy
      (z-pos 50)
      (x 7456)
      (y 736)
      (glinting #f)
    )
    (jumpy
      (z-pos 50)
      (x 14848)
      (y 1248)
      (glinting #f)
    )
    (jumpy
      (z-pos 50)
      (x 15808)
      (y 1248)
      (glinting #f)
    )
    (jumpy
      (z-pos 50)
      (x 10080)
      (y 1472)
      (glinting #f)
    )
    (mrbomb
      (z-pos 50)
      (x 4416)
      (y 1408)
      (glinting #f)
    )
    (mrbomb
      (z-pos 50)
      (x 14400)
      (y 1088)
      (glinting #f)
    )
    (mrbomb
      (z-pos 50)
      (x 14688)
      (y 1184)
      (glinting #f)
    )
    (mriceblock
      (z-pos 50)
      (x 2688)
      (y 1568)
      (glinting #f)
    )
    (music
      (name "Music_Object")
      (file "/music/misc/march_to_the_moon.music")
    )
    (secretarea
      (width 384)
      (height 320)
      (x 13472)
      (y 1504)
    )
    (secretarea
      (width 64)
      (height 544)
      (x 10224)
      (y 0)
    )
    (sequencetrigger
      (sequence "endsequence")
      (width 32)
      (height 1216)
      (x 16032)
      (y 0)
    )
    (sequencetrigger
      (sequence "stoptux")
      (width 32)
      (height 1248)
      (x 16640)
      (y 0)
    )
    (smartball
      (z-pos 50)
      (x 7584)
      (y 1088)
      (glinting #f)
    )
    (smartball
      (z-pos 50)
      (x 8416)
      (y 640)
      (glinting #f)
    )
    (smartball
      (z-pos 50)
      (x 12448)
      (y 1024)
      (glinting #f)
    )
    (smartblock
      (z-pos 50)
      (x 7392)
      (y 1088)
      (glinting #f)
    )
    (snowball
      (z-pos 50)
      (x 2592)
      (y 1568)
      (glinting #f)
    )
    (snowball
      (z-pos 50)
      (x 2496)
      (y 1568)
      (glinting #f)
    )
    (snowball
      (z-pos 50)
      (x 7488)
      (y 1088)
      (glinting #f)
    )
    (snowball
      (z-pos 50)
      (x 15488)
      (y 1280)
      (glinting #f)
    )
    (snowball
      (z-pos 50)
      (x 960)
      (y 1344)
      (glinting #f)
    )
    (snowball
      (z-pos 50)
      (x 1760)
      (y 1440)
      (glinting #f)
    )
    (snowball
      (z-pos 50)
      (x 3616)
      (y 1536)
      (glinting #f)
    )
    (snowball
      (z-pos 50)
      (x 5216)
      (y 960)
      (glinting #f)
    )
    (snowball
      (z-pos 50)
      (x 10496)
      (y 1504)
      (glinting #f)
    )
    (snowball
      (z-pos 50)
      (x 10176)
      (y 1504)
      (glinting #f)
    )
    (spawnpoint
      (name "main")
      (x 64)
      (y 1312)
    )
    (spawnpoint
      (x 9728)
      (y 1472)
    )
    (spawnpoint
      (name "two")
      (x 14000)
      (y 832)
    )
    (spiky
      (z-pos 50)
      (x 4544)
      (y 1408)
      (glinting #f)
    )
    (spiky
      (z-pos 50)
      (x 15360)
      (y 1280)
      (glinting #f)
    )
    (stalactite
      (type "rock")
      (glinting #f)
      (z-pos -1)
      (x 10208)
      (y 1408)
    )
    (tilemap
      (solid #f)
      (z-pos -100)
      (name "MidGround_Tiles")
      (width 525)
      (height 60)
      (tiles -10228 0 144 139 140 -522 0 141 142 143 -3067 0 175 -13 0 175 -510 0 171 -9 0 145 134 135 0 171 -313 0 163 -196 0 167 -9 0 136 137 138 0 167 -95 0 147 148 149 150 -214 0 171 -306 0 151 152 153 154 -214 0 171 -306 0 155 156 157 158 -148 0 145 134 135 -63 0 171 -306 0 159 160 161 162 -148 0 136 137 138 -7 0 147 148 149 150 -52 0 171 -468 0 151 152 153 154 -52 0 171 -344 0 84 -123 0 155 156 157 158 -52 0 171 -357 0 184 -110 0 159 160 161 162 -52 0 171 -4 0 147 148 149 150 -349 0 187 -166 0 171 0 128 129 0 151 152 153 154 -349 0 187 -166 0 171 0 130 131 0 155 156 157 158 -14 0 144 -334 0 187 -141 0 147 148 149 150 -21 0 171 0 132 133 0 159 160 161 162 -14 0 141 -325 0 79 -8 0 187 -141 0 151 152 153 154 -65 0 147 148 149 150 -310 0 187 -141 0 155 156 157 158 -12 0 145 134 135 -50 0 151 152 153 154 -310 0 187 -141 0 159 160 161 162 -12 0 136 137 138 -34 0 145 134 135 -13 0 155 156 157 158 -105 0 147 148 149 150 -201 0 190 -194 0 136 137 138 -13 0 159 160 161 162 -105 0 151 152 153 154 -521 0 155 156 157 158 -6 0 145 134 135 -432 0 144 139 140 -43 0 145 134 135 -31 0 159 160 161 162 -6 0 136 137 138 -432 0 141 142 143 -43 0 136 137 138 -497 0 147 148 149 150 -250 0 145 134 135 -268 0 151 152 153 154 -250 0 136 137 138 -268 0 155 156 157 158 -521 0 159 160 161 162 -3503 0 144 139 140 -522 0 141 142 143 -1670 0)
    )
    (tilemap
      (solid #f)
      (z-pos -150)
      (name "BackGround_Tiles")
      (width 525)
      (height 60)
      (tiles -31500 0)
    )
    (tilemap
      (solid #t)
      (z-pos 0)
      (name "Main_Tiles")
      (width 525)
      (height 60)
      (tiles -62 0 9 -24 10 11 -136 0 87 -109 0 9 -16 10 11 -109 0 9 -35 10 11 -89 0 9 -24 10 11 -136 0 87 -109 0 9 -16 10 11 -109 0 9 -35 10 11 -89 0 9 -24 10 11 -136 0 87 -109 0 9 -16 10 11 -109 0 9 -35 10 11 -89 0 9 -24 10 11 -136 0 87 -109 0 9 -16 10 11 -109 0 9 -35 10 11 -89 0 9 -24 10 11 -136 0 87 -109 0 9 -16 10 11 -109 0 9 -35 10 11 -89 0 9 -24 10 11 -136 0 87 -109 0 9 -16 10 11 -109 0 9 -35 10 11 -89 0 9 -24 10 11 -136 0 87 -109 0 9 -16 10 11 -109 0 9 -35 10 11 -89 0 9 -24 10 11 -136 0 87 -109 0 9 -16 10 11 -109 0 9 -35 10 11 -89 0 9 -24 10 11 -136 0 87 -109 0 9 -16 10 11 -109 0 9 -35 10 11 -89 0 9 -24 10 11 -136 0 87 -109 0 9 -16 10 11 -109 0 9 -35 10 11 -89 0 9 -24 10 11 -136 0 87 -109 0 9 -16 10 11 -109 0 9 -35 10 11 -89 0 9 -24 10 11 -136 0 87 -109 0 9 -16 10 11 -109 0 9 -35 10 11 -89 0 9 -24 10 11 -136 0 87 -109 0 9 -16 10 11 -109 0 9 -35 10 11 -89 0 9 -24 10 11 -136 0 87 -109 0 9 -16 10 11 -109 0 9 -35 10 11 -89 0 9 -24 10 11 -136 0 87 -109 0 9 -16 10 11 -109 0 9 -35 10 11 -89 0 9 -24 10 11 -136 0 87 -109 0 9 10 21 -12 14 22 10 11 -109 0 9 -35 10 11 -89 0 9 -24 10 11 -136 0 87 -94 0 1 2 3 -12 0 9 21 15 -12 0 13 22 11 -109 0 9 -35 10 11 -89 0 9 -24 10 11 -136 0 87 -2 0 83 -10 84 85 -80 0 5 6 7 -12 0 9 11 -14 0 9 11 -109 0 9 -35 10 11 -89 0 9 -24 10 11 -136 0 87 -2 0 82 -10 0 86 -80 0 9 10 11 -12 0 9 11 -14 0 9 11 -109 0 9 -35 10 11 -89 0 9 -24 10 11 -136 0 87 -13 0 87 -80 0 9 10 11 -12 0 9 11 -14 0 9 11 -109 0 9 -35 10 11 -89 0 9 -24 10 11 -136 0 87 -13 0 87 -8 0 1 -16 2 3 -54 0 9 10 11 -12 0 9 11 -14 0 9 11 -109 0 9 -35 10 11 -89 0 9 -24 10 11 -136 0 87 -13 0 87 -8 0 5 -16 6 23 3 -53 0 9 10 11 -12 0 13 15 -14 0 13 15 -109 0 9 -35 10 11 -89 0 9 -24 10 11 -136 0 87 -13 0 87 -8 0 9 -16 10 29 23 3 -52 0 9 10 11 -139 0 9 -35 10 11 -89 0 9 -24 10 11 -136 0 87 -13 0 87 -8 0 9 -17 10 29 23 3 -51 0 9 10 11 -139 0 9 -35 10 11 -89 0 9 -24 10 11 -136 0 88 -13 0 88 -8 0 9 -18 10 29 23 3 -50 0 9 10 11 -12 0 1 -16 2 3 -109 0 9 -35 10 11 -89 0 9 -24 10 11 -84 0 83 -15 84 85 -35 0 83 -9 84 85 -2 0 83 85 -8 0 9 -19 10 29 23 3 -49 0 9 10 11 -12 0 5 -16 6 7 -109 0 9 -35 10 11 -89 0 9 -24 10 11 -136 0 86 -9 0 82 -2 0 82 86 -8 0 9 -20 10 29 23 3 -48 0 9 10 11 -12 0 9 -16 10 11 -109 0 9 -35 10 11 -89 0 9 -24 10 11 -136 0 87 -13 0 87 -8 0 9 -21 10 29 23 3 -47 0 9 10 11 -12 0 9 -16 10 11 -109 0 9 -35 10 11 -89 0 9 -24 10 11 -82 0 1 -19 2 3 -33 0 87 -13 0 87 -8 0 9 -22 10 29 23 3 -46 0 9 10 11 -7 0 1 -4 2 26 -16 10 11 -109 0 9 -35 10 11 -89 0 9 -24 10 11 -82 0 5 -19 6 7 -33 0 88 -13 0 87 -8 0 9 -23 10 29 23 3 -45 0 9 10 11 -7 0 5 -4 6 30 -16 10 11 -5 0 83 -5 84 81 -5 84 85 -29 0 83 -5 84 81 -5 84 85 -49 0 13 22 -33 10 21 15 -89 0 9 -24 10 11 -59 0 1 -16 2 3 -5 0 13 -19 14 15 -47 0 87 -8 0 9 -24 10 29 23 3 -44 0 9 10 11 -7 0 13 -4 14 22 -16 10 11 -110 0 13 -33 14 15 -90 0 9 -24 10 11 -58 0 1 24 -16 6 7 -31 0 83 -7 84 85 -33 0 87 -8 0 9 -25 10 29 23 -16 2 3 -27 0 9 10 11 -12 0 9 -16 10 11 -81 0 1 -8 2 3 -144 0 9 -24 10 11 -58 0 5 30 -16 10 11 -73 0 87 -8 0 9 -26 10 29 -16 6 7 -27 0 9 10 11 -12 0 9 -16 10 11 -81 0 5 -8 6 7 -144 0 9 -24 10 11 -58 0 9 -17 10 11 -45 0 83 -7 84 85 -19 0 87 -8 0 9 -43 10 11 -27 0 9 10 11 84 85 -10 0 9 -16 10 11 -26 0 83 -5 84 81 -5 84 85 -42 0 9 -8 10 11 -144 0 9 -24 10 11 -58 0 9 -17 10 11 -73 0 88 -8 0 9 -43 10 11 -27 0 9 10 11 -11 0 182 9 -16 10 11 -81 0 9 -8 10 25 -8 2 3 -135 0 9 -24 10 11 -58 0 9 -17 10 11 -59 0 83 -13 84 85 -8 0 9 -43 10 11 -27 0 9 10 11 -11 0 185 9 -16 10 11 -81 0 9 -8 10 29 -8 6 7 -135 0 9 -24 10 11 -58 0 9 -17 10 11 -82 0 9 -43 10 11 -27 0 9 10 25 -3 2 3 -7 0 185 9 -16 10 11 -81 0 9 -17 10 11 -135 0 9 -24 10 11 -58 0 9 -17 10 11 -82 0 9 -43 10 11 -27 0 9 10 29 -3 6 7 -7 0 185 9 -16 10 11 -81 0 9 -17 10 25 -8 2 3 -37 0 1 -26 2 -62 0 9 -24 10 11 -58 0 9 -17 10 11 -82 0 9 -43 10 11 -27 0 9 10 21 -3 14 15 -7 0 185 9 -16 10 11 -81 0 9 -17 10 29 -8 6 7 -37 0 5 -26 6 -62 0 9 -24 10 11 -58 0 9 -17 10 11 -82 0 9 -43 10 25 -9 2 3 -17 0 9 10 11 -11 0 185 9 -16 10 11 -81 0 9 -26 10 11 -37 0 9 -26 10 -62 0 9 -24 10 11 -27 0 1 -3 2 3 -26 0 9 -17 10 11 -82 0 9 -43 10 29 -9 6 7 -17 0 9 10 11 -11 0 185 9 -16 10 11 -81 0 9 -26 10 25 -37 2 26 -26 10 -62 0 13 -24 14 15 -27 0 17 -3 18 19 -26 0 9 -17 10 11 -82 0 9 -53 10 11 -17 0 9 10 11 -11 0 188 9 -16 10 11 -81 0 9 -26 10 29 -37 6 30 -26 10 -31 2 3 -114 0 9 -17 10 11 -82 0 9 -53 10 11 -17 0 9 10 11 -12 0 9 -16 10 11 -81 0 9 -91 10 -31 6 23 3 -112 0 1 26 -17 10 11 -82 0 9 -53 10 11 -17 0 13 22 11 -12 0 9 -16 10 11 -81 0 9 -122 10 29 23 -7 2 3 -74 0 1 -29 2 24 30 -17 10 11 -82 0 9 -53 10 11 -18 0 13 15 -12 0 9 -16 10 11 -81 0 9 -123 10 29 -7 6 23 -15 2 3 -36 0 1 -9 2 3 -11 0 5 -29 6 30 -18 10 11 -82 0 9 -53 10 11 -28 0 1 -3 2 26 -16 10 11 -81 0 9 -131 10 29 -15 6 7 -36 0 5 -9 6 23 3 -10 0 9 -48 10 11 -82 0 9 -53 10 11 -28 0 5 -3 6 30 -16 10 11 -81 0 9 -147 10 11 -5 0 1 3 -22 0 1 3 -5 0 9 -9 10 29 23 3 -9 0 9 -48 10 11 -82 0 9 -53 10 25 -28 2 26 -20 10 11 -81 0 9 -147 10 11 -5 0 5 7 -22 0 5 7 -5 0 9 -10 10 29 23 -9 2 26 -48 10 11 -82 0 9 -53 10 29 -28 6 30 -20 10 11 -81 0 9 -147 10 11 -5 0 9 25 -22 2 26 11 -5 0 9 -11 10 29 -9 6 30 -48 10 11 -82 0 9 -103 10 11 -81 0 9 -147 10 11 -5 0 9 29 -22 6 30 11 -5 0 9 -70 10 11 -82 0 9 -103 10 11 -81 0 9 -147 10 11 -5 0 9 -24 10 11 -5 0 9 -70 10 11 -82 0 9 -103 10 11 -81 0 9 -147 10 11 -5 0 9 -24 10 11 -5 0 9 -70 10 11 -82 0 9 -103 10 11 -81 0 9 -147 10 11 -5 0 9 -24 10 11 -5 0 9 -70 10 11 -82 0 9 -103 10 11 -81 0 9 -147 10 11 -5 0 9 -24 10 11 -5 0 9 -70 10 11 -82 0 9 -103 10 11 -81 0 9 -147 10 11 -5 0 9 -24 10 11 -5 0 9 -70 10 11 -82 0 9 -103 10 11 -81 0 9 -147 10 11 -5 0 9 -24 10 11 -5 0 9 -70 10 11 -82 0 9 -103 10 11 -69 0 1 -11 2 26 -147 10 11 -5 0 9 -24 10 11 -5 0 9 -70 10 11 -82 0 9 -103 10 11 -69 0 5 -11 6 30 -147 10 11 -5 0 9 -24 10 11 -5 0 9 -70 10 11 -82 0 9 -103 10 11 -69 0 9 -159 10 11 -5 0 9 -24 10 11 -5 0 9 -70 10 11 -82 0 9 -103 10 11 -69 0 9 -103 10)
    )
    (tilemap
      (solid #f)
      (z-pos 1)
      (width 525)
      (height 60)
      (tiles -8627 0 89 -10 90 91 -513 0 93 -10 94 95 -3608 0 89 -15 90 91 -35 0 97 -2 90 98 -469 0 93 -15 94 95 -35 0 101 -2 94 102 -1704 0 89 -11 90 91 -29 0 89 -11 90 91 -470 0 93 -11 94 95 -29 0 93 -11 94 95 -309 0 89 -7 90 91 -516 0 93 -7 94 95 -530 0 89 -7 90 91 -102 0 97 90 91 -54 0 89 -11 90 91 -344 0 93 -7 94 95 -102 0 101 94 95 -54 0 93 -11 94 95 -358 0 89 98 -523 0 93 102 -12899 0)
    )
    (trampoline
      (z-pos 50)
      (x 3744)
      (y 1280)
    )
  )
)
