(supertux-level
  (version 3)
  (name (_ "Snowy Land"))
  (author "Sophie Ball")
  (license "CC-BY-SA 4.0 International")
  (allow-item-pocket "on")
  (icon "")
  (icon-locked "")
  (sector
    (name "main")
    (ambient-light
      (color 1 1 1)
    )
    (level
      (z-pos 50)
      (level "welcome_snowy_land.stl")
      (x 26)
      (y 89)
    )
    (level
      (z-pos 50)
      (x 30)
      (y 84)
    )
    (level
      (z-pos 50)
      (x 38)
      (y 84)
    )
    (level
      (z-pos 50)
      (x 38)
      (y 78)
    )
    (level
      (z-pos 50)
      (x 49)
      (y 78)
    )
    (level
      (z-pos 50)
      (x 25)
      (y 75)
    )
    (level
      (z-pos 50)
      (x 21)
      (y 70)
    )
    (level
      (z-pos 50)
      (x 16)
      (y 67)
    )
    (level
      (z-pos 50)
      (x 14)
      (y 63)
    )
    (level
      (z-pos 50)
      (x 11)
      (y 58)
    )
    (level
      (z-pos 50)
      (x 17)
      (y 49)
    )
    (level
      (z-pos 50)
      (x 23)
      (y 48)
    )
    (level
      (z-pos 50)
      (x 27)
      (y 52)
    )
    (level
      (z-pos 50)
      (x 22)
      (y 59)
    )
    (level
      (z-pos 50)
      (x 32)
      (y 78)
    )
    (level
      (z-pos 50)
      (x 44)
      (y 72)
    )
    (level
      (z-pos 50)
      (x 38)
      (y 70)
    )
    (level
      (z-pos 50)
      (x 32)
      (y 74)
    )
    (level
      (z-pos 50)
      (x 40)
      (y 60)
    )
    (level
      (z-pos 50)
      (x 54)
      (y 69)
    )
    (level
      (z-pos 50)
      (x 55)
      (y 62)
    )
    (level
      (z-pos 50)
      (x 63)
      (y 63)
    )
    (level
      (z-pos 50)
      (x 67)
      (y 59)
    )
    (level
      (z-pos 50)
      (x 70)
      (y 54)
    )
    (level
      (z-pos 50)
      (x 63)
      (y 47)
    )
    (level
      (z-pos 50)
      (x 57)
      (y 51)
    )
    (level
      (z-pos 50)
      (x 67)
      (y 49)
    )
    (level
      (z-pos 50)
      (x 47)
      (y 32)
    )
    (music
      (name "Music_Object")
      (file "/music/antarctic/christmas_eve.music")
    )
    (special-tile
      (z-pos 50)
      (blocking #f)
      (map-message (_ "Forest Land will be added soon..."))
      (invisible-tile #t)
      (passive-message #t)
      (x 47)
      (y 0)
    )
    (tilemap
      (solid #f)
      (z-pos -100)
      (name "Water_Tiles")
      (width 100)
      (height 100)
      (tiles -10000 1)
    )
    (tilemap
      (solid #t)
      (z-pos 0)
      (name "Main_Tiles")
      (width 100)
      (height 100)
      (tiles -3146 0 1031 1032 1033 -97 0 1034 1035 1036 -97 0 1034 1035 1036 -97 0 1037 1038 1039 -1073 0 1031 -6 1032 1033 -91 0 1031 1044 1042 -5 1035 1043 1032 1033 -27 0 1031 -7 1032 1033 -49 0 1031 -3 1032 1044 -6 1035 1042 -2 1035 1043 -2 1032 1033 -23 0 1031 1044 -7 1035 1043 1033 -46 0 1031 1032 1044 -16 1035 1043 1033 -20 0 1031 1032 1044 -9 1035 1043 1033 -44 0 1031 1044 -19 1035 1043 1032 1033 -17 0 1031 1044 -6 1035 1042 -5 1035 1043 1033 -42 0 1031 1044 -22 1035 1043 1032 1033 -13 0 1031 1032 1044 -3 1035 1045 -10 1035 1043 1033 -40 0 1031 1044 -16 1035 1045 -2 1035 1042 -5 1035 1043 1032 1033 -10 0 1031 1044 -9 1035 1045 1035 1048 -5 1035 1036 -39 0 1031 1044 -4 1035 1042 -10 1035 1046 1047 1035 1048 -9 1035 1043 1033 -8 0 1031 1044 -14 1035 1045 -3 1035 1036 -38 0 1031 1044 -4 1035 1045 1046 1047 1048 -8 1035 1049 1050 -6 1035 1045 -5 1035 1043 1032 1033 -5 0 1031 1044 -19 1035 1036 -38 0 1034 -6 1035 1049 1050 -21 1035 1048 -3 1035 1043 1033 -3 0 1031 1044 -8 1035 1042 -7 1035 1042 -3 1035 1036 -38 0 1034 -10 1035 1045 -23 1035 1043 -3 1032 1044 -3 1035 1042 -3 1035 1046 1047 -12 1035 1036 -38 0 1034 -18 1035 1042 -27 1035 1049 1050 -7 1035 1045 -2 1035 1048 1035 1036 -38 0 1034 -60 1035 1036 -38 0 1034 -10 1035 1042 -21 1035 1042 -14 1035 1045 -12 1035 1036 -38 0 1034 -9 1035 1048 -42 1035 1042 -6 1035 1040 1039 -38 0 1034 -21 1035 1042 -36 1035 1040 1039 -39 0 1034 -25 1035 1045 -15 1035 1046 1047 -8 1035 1045 -5 1035 1040 1039 -40 0 1034 -29 1035 1046 1047 -5 1035 1042 -4 1035 1049 1050 -11 1035 1042 1035 1040 1039 -41 0 1034 -20 1035 1045 -8 1035 1049 1050 -3 1035 1045 -20 1035 1040 1039 -42 0 1034 -16 1035 1042 -30 1035 1045 -4 1035 1048 1035 1040 1039 -43 0 1037 1041 -4 1035 1045 1048 -46 1035 1040 1039 -45 0 1037 1041 -6 1035 1042 -43 1035 1040 1039 -47 0 1034 -12 1035 1045 -19 1035 1042 -10 1035 1045 -5 1035 1040 1039 -48 0 1037 1041 -10 1035 1042 -15 1035 1045 -20 1035 1040 1039 -50 0 1037 1041 1035 1048 -43 1035 1040 1039 -52 0 1037 1041 -43 1035 1040 1039 -54 0 1037 1041 -11 1035 1048 1035 1045 -15 1035 1045 1046 1047 -6 1035 1042 1035 1045 1040 1039 -56 0 1037 1041 -2 1035 1048 -21 1035 1045 -4 1035 1049 1050 -2 1035 1042 -6 1035 1036 -58 0 1037 1041 -39 1035 1036 -59 0 1037 1041 -2 1035 1045 -7 1035 1042 -20 1035 1046 1047 -3 1035 1045 1035 1036 -60 0 1037 1038 1041 -29 1035 1049 1050 -5 1035 1036 -62 0 1037 1041 -6 1035 1045 -3 1035 1045 -12 1035 1042 -5 1035 1045 -3 1035 1048 1035 1036 -63 0 1034 -21 1035 1045 -11 1035 1042 1040 1039 -63 0 1037 1041 -33 1035 1036 -65 0 1034 -20 1035 1048 -9 1035 1045 1035 1040 1039 -65 0 1037 1041 -5 1035 1045 -9 1035 1046 1047 -5 1035 1045 -8 1035 1036 -67 0 1034 1048 -3 1035 1042 -10 1035 1049 1050 -13 1035 1040 1039 -67 0 1034 -21 1035 1042 -7 1035 1040 1039 -68 0 1037 1041 -14 1035 1045 -12 1035 1040 1039 -70 0 1034 1042 -23 1035 1045 1040 1038 1039 -70 0 1031 1044 -2 1035 1045 -9 1035 1045 -3 1035 1042 -6 1035 1045 1040 1039 -71 0 1031 1044 -7 1035 1045 -14 1035 1040 -2 1038 1039 -72 0 1034 -3 1035 1045 -2 1035 1046 1047 -2 1035 1040 -12 1038 1039 -75 0 1034 1048 -5 1035 1049 1050 1035 1040 1039 -88 0 1034 -5 1035 1042 -3 1035 1036 -89 0 1037 1041 -3 1035 1048 1035 1045 1035 1040 1039 -90 0 1037 1041 -5 1035 1040 1039 -92 0 1037 -5 1038 1039 -768 0)
    )
    (tilemap
      (solid #t)
      (z-pos 1)
      (width 100)
      (height 100)
      (tiles -47 0 41 -99 0 41 -99 0 41 -99 0 41 -99 0 41 -99 0 41 -99 0 41 -99 0 41 -99 0 41 -99 0 41 -99 0 41 -99 0 41 -99 0 41 -99 0 41 -99 0 41 -99 0 41 -99 0 41 -99 0 41 -99 0 41 -99 0 41 -99 0 41 -99 0 41 -99 0 41 -99 0 41 -99 0 41 -99 0 41 -99 0 41 -99 0 41 -99 0 41 -99 0 41 -99 0 54 -99 0 55 -99 0 21 -99 0 21 -99 0 52 -99 0 53 -99 0 41 -99 0 41 -99 0 41 -99 0 41 -99 0 41 -99 0 41 -99 0 41 -99 0 41 -99 0 41 -99 0 41 -99 0 41 -99 0 41 -12 0 10 -5 20 11 -51 0 10 -8 20 11 -19 0 41 -12 0 21 -5 0 21 -49 0 10 20 15 -8 0 21 -19 0 41 -10 0 10 20 15 -5 0 14 20 11 -46 0 10 15 -4 0 1031 -3 1032 1033 0 21 -19 0 41 -10 0 21 -9 0 21 -45 0 10 15 -5 0 1034 -3 1035 1036 0 21 -19 0 41 -8 0 10 20 15 -9 0 14 20 11 -42 0 10 15 -6 0 1034 -3 1035 1036 0 21 -19 0 41 -8 0 21 -4 0 69 -2 70 71 -5 0 21 -41 0 10 15 -7 0 1034 -2 1035 1040 1039 0 21 -19 0 41 -8 0 21 -3 0 69 81 -2 73 80 71 -4 0 21 -40 0 10 15 -8 0 1037 -2 1038 1039 -2 0 21 -3 0 69 -2 70 71 -12 0 54 -8 0 21 -3 0 72 -4 73 74 -4 0 21 -40 0 21 -2 0 1031 -3 1032 1033 -6 0 10 20 15 -3 0 72 82 73 80 71 -6 0 1031 1032 1033 -2 0 55 -8 0 21 -3 0 72 -4 73 74 -4 0 21 -40 0 21 0 1031 1044 -3 1035 1036 -6 0 21 -5 0 72 -3 73 74 0 1031 1033 -3 0 1037 1038 1039 -2 0 21 0 1031 -2 1032 1033 -3 0 21 -3 0 75 79 -3 73 74 -4 0 21 -40 0 21 0 1034 -4 1035 1036 -4 0 10 20 15 -5 0 72 -3 73 74 0 1037 1039 -8 0 21 0 1034 -2 1035 1043 1033 -2 0 21 -4 0 72 -3 73 74 -2 0 10 20 15 -40 0 21 0 1034 -4 1035 1036 -4 0 21 -7 0 75 79 -2 73 74 -11 0 21 0 1034 -3 1035 1036 -2 0 21 -4 0 75 -3 76 77 -2 0 21 -42 0 21 0 1034 -4 1035 1036 -2 0 10 20 15 -4 0 1031 1032 1033 0 75 79 73 74 -11 0 21 0 1034 -3 1035 1036 -2 0 21 -9 0 10 20 15 -42 0 21 0 1034 -4 1035 1036 -2 0 21 -6 0 1034 1035 1036 -2 0 75 76 77 -2 0 10 -8 20 15 0 1037 -3 1038 1039 0 10 15 0 1031 1032 1033 -5 0 21 -44 0 21 0 1034 -3 1035 1040 1039 10 20 15 -3 0 1031 1032 1033 1037 1038 1039 -7 0 21 -16 0 21 -2 0 1034 1035 1036 -3 0 10 20 15 -44 0 21 0 1037 -3 1038 1039 0 21 -5 0 1034 1035 1036 -10 0 21 -16 0 21 -2 0 1037 1038 1039 -3 0 21 -46 0 14 -2 20 13 -4 20 15 -2 0 1031 1032 1033 1037 1038 1039 -10 0 21 -9 0 69 -2 70 71 -3 0 21 -6 0 10 20 15 -49 0 21 -7 0 1034 1035 1036 -4 0 69 70 71 0 1031 -2 1032 1033 0 21 -8 0 69 81 82 73 80 71 0 10 15 -6 0 21 -51 0 21 -7 0 1037 1038 1039 -3 0 69 81 73 74 0 1034 -2 1035 1036 0 21 -2 0 1031 1032 1033 -2 0 69 81 -2 73 82 73 74 0 21 -5 0 10 20 15 -51 0 21 -13 0 72 -2 73 74 0 1034 -2 1035 1036 0 21 -2 0 1034 1035 1036 -2 0 72 -5 73 74 0 21 -5 0 21 -53 0 14 -3 20 11 -8 0 69 81 73 78 77 0 1034 -2 1035 1036 0 21 -2 0 1037 1038 1039 -2 0 72 -4 73 78 77 0 21 -3 0 10 20 15 -57 0 21 -8 0 72 -2 73 74 1031 1033 1037 -2 1038 1039 0 21 -7 0 72 -4 73 74 -2 0 21 -3 0 21 -59 0 21 -8 0 72 82 78 77 1037 1039 -5 0 21 -7 0 72 -4 73 74 -2 0 12 -3 20 15 -59 0 14 -5 20 11 -2 0 75 76 77 -2 0 10 -5 20 16 -5 20 11 0 75 -4 76 77 -2 0 21 -69 0 21 -7 0 21 -11 0 21 -9 0 21 -69 0 21 -7 0 21 -2 0 1031 -5 1032 1033 -2 0 21 -9 0 21 -69 0 21 -2 0 1031 1033 -3 0 21 -2 0 1034 -5 1035 1036 -2 0 21 -9 0 21 -69 0 21 -2 0 1037 1039 -3 0 21 -2 0 1034 -5 1035 1036 -2 0 14 -4 20 11 -4 0 21 -69 0 14 20 11 -5 0 21 -2 0 1034 -5 1035 1036 -7 0 21 -4 0 21 -71 0 21 -5 0 21 -2 0 1037 -5 1038 1039 -7 0 21 -4 0 21 -71 0 21 -5 0 21 -16 0 21 -4 0 21 -71 0 12 -5 20 16 -5 20 13 -10 20 24 -4 20 15 -71 0 21 -4 0 69 70 71 -4 0 21 -10 0 21 1031 1032 1033 -73 0 21 -4 0 72 73 80 71 0 1031 1033 21 -3 0 69 -2 70 71 -3 0 21 1034 1035 1036 -73 0 21 -4 0 75 79 73 80 71 1034 1036 21 -2 0 69 81 -2 73 74 -3 0 21 1037 1038 1039 -73 0 14 -3 20 11 0 72 -2 73 74 1037 1039 21 -2 0 72 73 78 76 77 -3 0 21 -80 0 21 0 75 -2 76 77 -2 0 21 -2 0 75 76 77 -5 0 21 -80 0 12 -7 20 16 -10 20 15 -80 0 21 -95 0 10 -3 20 15 -95 0 21 -99 0 21 -99 0 21 -99 0 21 -99 0 21 -99 0 52 -99 0 53 -673 0)
    )
    (tilemap
      (solid #f)
      (z-pos 2)
      (width 100)
      (height 100)
      (tiles -5122 0 1031 1032 1033 -97 0 1034 1040 1039 -97 0 1037 1039 -291 0 1031 1032 1033 -96 0 1031 1044 1035 1036 -32 0 1031 1033 -62 0 1034 -2 1035 1036 -21 0 60 61 62 -8 0 1034 1043 1033 -61 0 1034 -2 1035 1036 -21 0 63 64 65 -8 0 1037 1038 1039 -61 0 1034 1035 1040 1039 -21 0 66 67 68 -72 0 1037 1038 1039 -417 0 1031 1033 -98 0 1034 1036 -98 0 1037 1039 -600 0 1031 -3 1032 1033 -95 0 1034 -3 1035 1036 -95 0 1037 -3 1038 1039 -2459 0)
    )
    (tilemap
      (solid #f)
      (z-pos 3)
      (width 100)
      (height 100)
      (tiles -5815 0 1031 1033 -98 0 1037 1039 -4083 0)
    )
    (worldmap-spawnpoint
      (z-pos 50)
      (name "main")
      (x 26)
      (y 93)
    )
  )
  (tileset "images/ice_world.strf")
)
