(supertux-level
  (version 3)
  (name (_ "Menu Level"))
  (author "Sophie Ball")
  (contact "whatttttt")
  (license "CC-BY-SA 4.0 International")
  (allow-item-pocket "inherit")
  (icon "")
  (icon-locked "")
  (statistics
    (enable-coins #t)
    (enable-secrets #t)
  )
  (sector
    (name "main")
    (init-script "Tux.deactivate();")
    (ambient-light
      (color 1 1 1)
    )
    (background
      (color 1 1 1)
      (alignment "top")
      (scroll-speed-x -15)
      (speed 0)
      (image "/images/background/misc/clouds.png")
      (z-pos -399)
    )
    (camera
      (name "Camera")
      (mode "normal")
    )
    (gradient
      (top_color 0.5 0.7 1)
      (bottom_color 1 1 1)
      (z-pos -400)
    )
    (music
      (name "Music_Object")
      (file "/music/misc/theme.music")
    )
    (particles-snow
    )
    (spawnpoint
      (name "main")
      (x 224)
      (y 832)
    )
    (tilemap
      (solid #f)
      (z-pos -100)
      (width 47)
      (height 30)
      (tiles -895 0 147 148 149 150 -35 0 147 148 149 150 -4 0 151 152 153 154 -19 0 128 129 -14 0 151 152 153 154 -4 0 155 156 157 158 -10 0 144 139 140 -6 0 130 131 -5 0 145 134 135 -6 0 155 156 157 158 -4 0 159 160 161 162 -10 0 141 142 143 -6 0 132 133 -5 0 136 137 138 -6 0 159 160 161 162 -331 0)
    )
    (tilemap
      (solid #f)
      (z-pos 100)
      (name "BackGround_Tiles")
      (width 47)
      (height 30)
      (tiles -1181 0 -3 10 -44 0 -3 10 -44 0 -3 10 -44 0 -3 10 -85 0)
    )
    (tilemap
      (solid #t)
      (z-pos 0)
      (name "Main_Tiles")
      (width 47)
      (height 30)
      (tiles -1034 0 -47 2 -4 6 32 -11 6 32 -11 6 32 -4 6 32 -12 6 32 -49 10 33 -3 10 -3 0 -9 10 33 -6 10 21 -4 14 22 -6 10 33 -15 10 -3 0 -16 10 25 -4 2 26 -10 10 21 22 10 33 -8 10 -3 0 -16 10 29 -4 6 30 -10 10 25 26 -16 10 33 -23 10 33 -4 10 29 30 -51 10)
    )
    (tilemap
      (solid #f)
      (tint 0.5 0.5 0.5)
      (z-pos -50)
      (width 47)
      (height 30)
      (tiles -1200 0 -6 10 -41 0 -6 10 -10 0 -2 10 -45 0 -2 10 -98 0)
    )
    (tilemap
      (solid #f)
      (z-pos -250)
      (width 47)
      (height 30)
      (tiles -720 0 105 -15 106 107 -15 0 -15 106 108 -15 110 112 -10 0 105 -4 106 -31 110 113 -10 106 108 -568 110)
    )
    (tilemap
      (solid #f)
      (z-pos -300)
      (width 47)
      (height 30)
      (tiles -478 0 117 -8 118 119 -15 0 117 -8 118 119 -4 0 -8 118 120 -8 122 123 -6 0 117 -8 118 120 -8 122 123 -4 0 -17 122 124 -6 118 120 -17 122 124 -4 118 -799 122)
    )
  )
)
